74 74 74 74 74 74 74 74 74 74 74 74 74 74 74 74 74 74 74 74 74 74 74 74 74 74 74 74 74 74 74 74 74 74 74 74 74 74 74 74 74 74 74 74 74 74 74 74 74 74
74 74 74 74 74 74 74 74 74 74 74 74 74 74 74 74 74 74 74 74 74 74 74 74 74 74 74 74 74 74 74 74 74 74 74 74 74 74 74 74 74 74 74 74 74 74 74 74 74 74
74 74 74 74 74 74 74 74 74 74 74 74 74 74 74 74 74 74 74 74 74 74 74 74 74 74 74 74 74 74 74 74 74 74 74 74 74 74 74 74 74 74 74 74 74 74 74 74 74 74
74 74 74 74 74 74 74 74 74 74 74 74 74 74 74 74 74 74 74 74 74 74 74 74 74 74 74 74 74 74 74 74 74 74 74 74 74 74 74 74 74 74 74 74 74 74 74 74 74 74
74 74 74 74 74 74 74 74 74 74 74 74 74 74 74 74 74 74 74 74 74 74 74 74 74 74 74 74 74 74 74 74 74 74 74 74 74 74 74 74 74 74 74 74 74 74 74 74 74 74
74 74 74 74 74 74 74 74 74 74 74 74 74 74 74 74 74 74 74 74 74 74 74 74 74 74 74 74 74 74 74 74 74 74 74 74 74 74 74 74 74 74 74 74 74 74 74 74 74 74
74 74 74 74 74 74 74 74 74 74 74 74 74 74 74 74 74 74 74 74 74 74 74 74 74 74 74 74 74 74 74 74 74 74 74 74 74 74 74 74 74 74 74 74 74 74 74 74 74 74
74 74 74 74 74 74 74 74 74 74 74 74 74 74 74 74 74 74 74 74 74 74 74 74 74 74 74 74 74 74 74 74 74 74 74 74 74 74 74 74 74 74 74 74 74 74 74 74 74 74
74 74 74 74 74 74 74 74 74 74 74 74 74 74 74 74 74 74 74 74 74 74 74 74 74 74 74 74 74 74 74 74 74 74 74 74 74 74 74 74 74 74 74 74 74 74 74 74 74 74
74 74 74 74 74 74 74 74 74 74 74 74 74 74 74 74 74 74 74 74 74 74 74 74 74 74 74 74 74 74 74 74 74 74 74 74 74 74 74 74 74 74 74 74 74 74 74 74 74 74
74 74 74 74 74 74 74 74 74 74 74 74 74 74 74 74 74 74 74 74 74 74 74 74 74 74 74 74 74 74 74 74 74 74 74 74 74 74 74 74 74 74 74 74 74 74 74 74 74 74   
74 74 74 74 74 74 74 74 74 74 74 74 74 74 74 74 74 74 74 74 74 74 74 74 74 74 74 74 74 74 74 74 74 74 74 74 74 74 74 74 74 74 74 74 74 74 74 74 74 74   
74 74 74 74 74 74 74 74 74 74 74 63 62 62 62 62 62 62 62 62 62 62 62 62 62 62 62 64 74 74 74 74 74 74 74 74 74 74 74 74 74 74 74 74 74 74 74 74 74 74   
74 74 74 74 74 74 74 74 74 74 74 67 69 69 69 69 69 69 69 69 69 69 69 69 69 69 69 68 74 74 74 74 74 74 74 74 74 74 74 74 74 74 74 74 74 74 74 74 74 74  
74 74 74 63 62 62 62 62 62 62 62 69 69 69 69 69 69 69 69 75 69 69 69 69 69 75 69 69 62 62 62 62 62 62 62 62 62 62 62 62 62 62 62 62 62 62 64 74 74 74 
74 74 74 67 69 69 69 69 69 69 75 69 69 69 69 69 69 69 69 69 69 69 69 69 69 69 69 69 65 65 65 65 65 65 65 65 65 65 65 65 65 65 65 65 65 69 68 74 74 74 
74 74 74 67 69 75 65 65 65 65 65 69 69 69 69 69 75 75 69 69 69 69 69 69 69 69 69 68 74 74 74 74 74 74 74 74 74 74 74 74 74 74 74 74 74 67 68 74 74 74
74 74 74 67 69 68 74 74 74 74 74 67 69 69 69 69 69 69 75 69 69 69 69 69 69 69 69 68 74 74 74 74 74 74 74 74 74 74 74 74 74 74 74 74 74 67 68 74 74 74   
74 74 74 67 69 68 74 74 74 74 74 60 65 65 65 65 65 65 65 65 65 65 65 65 65 65 65 71 74 74 74 74 74 74 74 74 74 74 74 74 74 74 74 74 74 67 68 74 74 74
74 74 74 67 69 68 74 74 74 74 74 74 74 74 74 74 74 74 74 74 74 74 74 74 74 74 74 74 74 74 74 74 74 74 74 74 74 74 74 74 74 74 74 74 74 67 68 74 74 74
74 74 74 67 75 68 74 74 74 74 74 74 74 74 74 74 74 74 74 74 74 74 74 74 74 74 74 74 74 74 74 74 74 74 74 74 74 74 74 74 74 74 74 74 74 67 68 74 74 74 
74 74 74 67 69 68 74 74 74 74 74 74 74 74 74 74 74 74 74 74 74 74 74 74 74 74 74 74 74 74 74 74 74 74 74 74 74 74 74 74 74 74 74 74 74 67 68 74 74 74 
74 74 74 67 69 68 74 74 74 74 74 74 74 74 74 74 74 74 74 74 74 74 74 74 74 74 74 74 74 74 74 74 74 74 74 74 74 74 74 74 74 74 74 74 74 67 68 74 74 74 
74 74 74 67 69 68 74 74 74 74 74 74 74 74 74 74 74 74 74 74 74 74 74 74 74 74 74 74 74 74 74 74 74 74 74 74 74 74 74 74 74 74 74 74 74 67 68 74 74 74 
74 74 74 67 75 68 74 74 74 74 74 74 74 74 74 74 74 74 74 74 74 74 74 74 74 74 74 74 74 74 74 74 74 74 74 74 74 74 74 74 74 74 74 74 74 67 68 74 74 74
74 74 74 67 69 68 74 74 74 74 74 74 74 74 74 74 74 74 74 74 74 74 74 74 74 74 74 74 74 74 74 74 74 74 74 74 74 74 74 74 74 74 74 74 74 67 68 74 74 74 
74 74 74 67 69 68 74 74 74 74 74 74 74 74 74 74 74 74 74 74 74 74 74 74 74 74 74 74 63 62 62 62 62 62 62 62 62 62 62 62 62 62 62 62 62 69 68 74 74 74 
74 74 74 67 75 68 74 74 74 74 74 74 74 74 74 74 74 74 74 74 74 74 74 74 74 74 74 74 67 69 69 65 65 65 65 65 65 65 65 65 65 65 65 65 65 65 71 74 74 74 
74 74 74 67 69 68 74 74 74 74 74 74 74 74 74 74 74 74 74 74 74 74 74 74 74 74 74 74 67 75 68 74 74 74 74 74 74 74 74 74 74 74 74 74 74 74 74 74 74 74
74 74 74 67 69 68 74 74 74 74 74 74 74 74 74 74 74 74 74 74 74 74 74 74 74 74 74 74 67 69 68 74 74 74 74 74 74 74 74 74 74 74 74 74 74 74 74 74 74 74 
74 74 74 67 69 68 74 74 74 74 74 74 74 74 74 74 74 74 74 74 74 74 74 74 74 74 74 74 67 69 68 74 74 74 74 74 74 74 74 74 74 74 74 74 74 74 74 74 74 74 
63 62 62 66 66 66 62 62 64 74 74 74 74 74 74 74 74 74 74 74 74 74 74 74 74 74 74 74 66 66 66 74 74 74 74 74 74 74 74 74 74 74 74 74 74 74 74 74 74 74 
67 69 69 69 75 69 69 69 68 74 74 74 74 74 74 74 63 62 62 62 62 62 62 62 62 62 62 62 69 69 75 62 62 62 62 62 62 62 62 62 62 62 62 62 64 74 74 74 74 74
67 69 69 69 69 69 69 69 68 74 74 74 74 74 74 74 67 69 69 69 75 69 69 69 69 69 69 69 69 69 69 69 69 69 69 69 69 69 69 69 69 69 69 69 68 74 74 74 74 74
67 69 69 69 69 69 69 69 68 74 74 74 74 74 74 74 67 75 69 69 69 69 69 69 69 69 69 69 69 69 69 69 69 69 75 69 69 69 69 69 69 69 69 69 68 74 74 74 74 74
67 69 75 69 69 69 75 69 68 74 74 74 74 74 74 74 67 69 69 75 69 69 69 69 69 69 69 75 69 69 69 75 69 69 69 69 69 69 69 75 69 69 69 69 68 74 74 74 74 74
67 69 69 69 75 69 69 69 68 74 74 74 74 74 74 74 67 69 69 69 69 69 69 69 69 69 69 69 69 69 69 69 69 69 69 69 69 69 69 69 69 69 69 69 68 74 74 74 74 74
67 69 69 69 69 69 75 69 68 74 74 74 74 74 74 74 67 69 69 69 69 69 75 69 69 69 69 69 69 75 69 69 69 69 75 69 69 69 69 69 69 75 69 69 68 74 74 74 74 74
67 69 69 69 69 69 69 69 68 74 74 74 74 74 74 74 67 69 69 69 69 69 69 69 69 69 69 69 69 69 69 69 69 69 69 69 69 69 69 69 69 69 69 69 68 74 74 74 74 74
67 69 75 69 69 69 69 69 68 74 74 74 74 74 74 74 67 69 75 69 69 69 69 69 69 69 69 69 69 69 69 75 69 69 69 69 69 69 69 69 69 69 69 69 68 74 74 74 74 74
60 65 65 65 65 65 65 65 71 74 74 74 74 74 74 74 67 69 69 69 69 69 69 69 69 69 69 69 69 69 69 69 69 69 69 69 69 69 69 69 69 69 69 69 68 74 74 74 74 74
74 74 74 74 74 74 74 74 74 74 74 74 74 74 74 74 67 69 69 69 75 69 69 69 69 69 69 69 75 69 69 69 69 69 69 69 69 69 69 69 69 69 75 69 68 74 74 74 74 74
74 74 74 74 74 74 74 74 74 74 74 74 74 74 74 74 67 69 69 69 69 69 69 75 69 69 69 69 69 69 69 69 69 69 69 69 69 69 69 69 69 69 69 69 68 74 74 74 74 74
74 74 74 74 74 74 74 74 74 74 74 74 74 74 74 74 67 69 69 69 69 69 69 69 69 69 69 69 69 69 75 69 69 69 75 69 69 69 69 69 69 75 69 69 68 74 74 74 74 74
74 74 74 74 74 74 74 74 74 74 74 74 74 74 74 74 67 69 69 69 69 75 69 69 69 69 69 69 69 69 69 69 69 69 69 69 69 69 69 69 69 69 69 69 68 74 74 74 74 74
74 74 74 74 74 74 74 74 74 74 74 74 74 74 74 74 67 69 69 69 69 69 69 69 69 69 69 69 69 69 69 69 69 69 69 69 69 69 69 69 69 69 69 69 68 74 74 74 74 74
74 74 74 74 74 74 74 74 74 74 74 74 74 74 74 74 60 65 65 65 65 65 65 65 65 65 65 65 65 65 65 65 65 65 65 65 65 65 65 65 65 65 65 65 71 74 74 74 74 74
74 74 74 74 74 74 74 74 74 74 74 74 74 74 74 74 74 74 74 74 74 74 74 74 74 74 74 74 74 74 74 74 74 74 74 74 74 74 74 74 74 74 74 74 74 74 74 74 74 74
74 74 74 74 74 74 74 74 74 74 74 74 74 74 74 74 74 74 74 74 74 74 74 74 74 74 74 74 74 74 74 74 74 74 74 74 74 74 74 74 74 74 74 74 74 74 74 74 74 74
74 74 74 74 74 74 74 74 74 74 74 74 74 74 74 74 74 74 74 74 74 74 74 74 74 74 74 74 74 74 74 74 74 74 74 74 74 74 74 74 74 74 74 74 74 74 74 74 74 74