0 0 0 0 0 0 0 0 0 0 63 62 62 62 62 62 62 62 62 62 62 62 62 62 62 62 62 62 62 62 62 62 62 62 62 62 62 62 62 64 0 0 0 0 0 0 0 0 0 0 
0 0 0 0 0 0 0 0 0 0 67 69 69 69 69 69 69 69 69 69 69 69 69 69 69 69 69 69 69 69 69 69 69 69 69 69 69 69 69 68 0 0 0 0 0 0 0 0 0 0 
0 0 0 0 0 0 0 0 0 0 67 69 69 69 69 69 69 69 69 69 69 69 69 69 69 69 69 69 69 69 69 69 69 69 69 69 69 69 69 68 0 0 0 0 0 0 0 0 0 0 
0 0 0 0 0 0 0 0 0 0 67 69 69 69 69 69 69 69 69 69 69 69 69 69 69 69 69 69 69 69 69 69 69 69 69 69 69 69 69 68 0 0 0 0 0 0 0 0 0 0 
0 0 0 0 0 0 0 0 0 0 67 69 69 69 63 62 62 62 62 62 62 62 62 62 62 62 62 62 62 62 62 62 62 62 62 64 69 69 69 68 0 0 0 0 0 0 0 0 0 0 
0 0 0 0 0 0 0 0 0 0 67 69 69 69 67 72 72 72 72 72 72 72 72 72 72 72 72 72 72 72 72 72 72 72 72 68 69 69 69 68 0 0 0 0 0 0 0 0 0 0 
0 0 0 0 0 0 0 0 0 0 67 69 69 69 67 72 63 62 62 62 62 62 62 62 62 62 62 62 62 62 62 62 62 64 72 68 69 69 69 68 0 0 0 0 0 0 0 0 0 0 
0 0 0 0 0 0 0 0 0 0 67 69 69 69 67 72 67 69 69 69 69 69 69 69 69 69 69 69 69 69 69 69 69 68 72 68 69 69 69 68 0 0 0 0 0 0 0 0 0 0 
0 0 0 0 0 0 0 0 0 0 67 69 69 69 67 72 67 69 69 69 69 69 69 69 69 69 69 69 69 69 69 69 69 68 72 68 69 69 69 68 0 0 0 0 0 0 0 0 0 0 
0 0 0 0 0 0 0 0 0 0 67 69 69 69 67 72 67 69 69 69 69 69 69 69 69 69 69 69 69 69 69 69 69 68 72 68 69 69 69 68 0 0 0 0 0 0 0 0 0 0 
0 0 0 0 0 0 0 0 0 0 67 69 69 69 67 72 67 69 69 69 69 69 69 69 69 69 69 69 69 69 69 69 69 68 72 68 69 69 69 68 0 0 0 0 0 0 0 0 0 0 
0 0 0 0 0 0 0 0 0 0 67 69 69 69 67 72 67 69 69 69 69 69 69 69 69 69 69 69 69 69 69 69 69 68 72 68 69 69 69 68 0 0 0 0 0 0 0 0 0 0 
0 0 0 0 0 0 0 0 0 0 67 69 69 69 67 72 67 69 69 69 69 69 69 69 69 69 69 69 69 69 69 69 69 68 72 68 69 69 69 68 0 0 0 0 0 0 0 0 0 0 
0 0 0 0 0 0 0 0 0 0 67 69 69 69 67 72 67 69 69 69 69 69 69 69 69 69 69 69 69 69 69 69 69 68 72 68 69 69 69 68 0 0 0 0 0 0 0 0 0 0 
0 0 0 0 0 0 0 0 0 0 67 69 69 69 67 72 67 69 69 69 69 69 69 69 69 69 69 69 69 69 69 69 69 68 72 68 69 69 69 68 0 0 0 0 0 0 0 0 0 0 
0 0 0 0 0 0 0 0 0 0 67 69 69 69 67 72 67 69 69 69 69 69 69 69 69 69 69 69 69 69 69 69 69 68 72 68 69 69 69 68 0 0 0 0 0 0 0 0 0 0 
0 0 0 0 0 0 0 0 0 0 67 69 69 69 67 72 67 69 69 69 69 69 69 69 69 69 69 69 69 69 69 69 69 68 72 68 69 69 69 68 0 0 0 0 0 0 0 0 0 0 
0 0 0 0 0 0 0 0 0 0 67 69 69 69 67 72 60 65 65 65 65 65 65 65 66 66 65 65 65 65 65 65 65 71 72 68 69 69 69 68 0 0 0 0 0 0 0 0 0 0 
0 0 0 0 0 0 0 0 0 0 67 69 69 69 67 72 72 72 72 72 72 72 72 72 66 66 72 72 72 72 72 72 72 72 72 68 69 69 69 68 0 0 0 0 0 0 0 0 0 0 
0 0 0 0 0 0 0 0 0 0 67 69 69 69 60 65 65 65 65 65 65 65 65 65 66 66 65 65 65 65 65 65 65 65 65 71 69 69 69 68 0 0 0 0 0 0 0 0 0 0 
0 0 0 0 0 0 0 0 0 0 67 69 69 69 69 69 69 69 69 69 69 69 69 69 69 69 69 69 69 69 69 69 69 69 69 69 69 69 69 68 0 0 0 0 0 0 0 0 0 0 
0 0 0 0 0 0 0 0 0 0 67 69 69 69 69 69 69 69 69 69 69 69 69 69 69 69 69 69 69 69 69 69 69 69 69 69 69 69 69 68 0 0 0 0 0 0 0 0 0 0 
0 0 0 0 0 0 0 0 0 0 67 69 69 69 69 69 69 69 69 69 69 69 69 69 69 69 69 69 69 69 69 69 69 69 69 69 69 69 69 68 0 0 0 0 0 0 0 0 0 0 
0 0 0 0 0 0 0 0 0 0 67 69 69 69 69 69 69 69 69 69 69 69 69 69 69 69 69 69 69 69 69 69 69 69 69 69 69 69 69 68 0 0 0 0 0 0 0 0 0 0 
0 0 0 0 0 0 0 0 0 0 67 69 69 69 69 69 69 69 69 69 69 69 69 69 69 69 69 69 69 69 69 69 69 69 69 69 69 69 69 68 0 0 0 0 0 0 0 0 0 0 
0 0 0 0 0 0 0 0 0 0 67 69 69 69 69 69 69 69 69 69 69 69 69 69 69 69 69 69 69 69 69 69 69 69 69 69 69 69 69 68 0 0 0 0 0 0 0 0 0 0 
0 0 0 0 0 0 0 0 0 0 67 69 69 69 69 69 69 69 69 69 69 69 69 69 69 69 69 69 69 69 69 69 69 69 69 69 69 69 69 68 0 0 0 0 0 0 0 0 0 0 
0 0 0 0 0 0 0 0 0 0 67 69 69 69 69 69 69 69 69 69 69 69 69 69 69 69 69 69 69 69 69 69 69 69 69 69 69 69 69 68 0 0 0 0 0 0 0 0 0 0 
0 0 0 0 0 0 0 0 0 0 67 69 69 69 69 69 69 69 69 69 69 69 69 69 69 69 69 69 69 69 69 69 69 69 69 69 69 69 69 68 0 0 0 0 0 0 0 0 0 0 
0 0 0 0 0 0 0 0 0 0 60 65 65 65 65 65 65 65 65 65 65 65 65 65 65 65 65 65 65 65 65 65 65 65 65 65 65 65 65 71 0 0 0 0 0 0 0 0 0 0 
0 0 0 0 0 0 0 0 0 0 0 0 0 0 0 0 0 0 0 0 0 0 0 0 0 0 0 0 0 0 0 0 0 0 0 0 0 0 0 0 0 0 0 0 0 0 0 0 0 0    
0 0 0 0 0 0 0 0 0 0 0 0 0 0 0 0 0 0 0 0 0 0 0 0 0 0 0 0 0 0 0 0 0 0 0 0 0 0 0 0 0 0 0 0 0 0 0 0 0 0    
0 0 0 0 0 0 0 0 0 0 0 0 0 0 0 0 0 0 0 0 0 0 0 0 0 0 0 0 0 0 0 0 0 0 0 0 0 0 0 0 0 0 0 0 0 0 0 0 0 0    
0 0 0 0 0 0 0 0 0 0 0 0 0 0 0 0 0 0 0 0 0 0 0 0 0 0 0 0 0 0 0 0 0 0 0 0 0 0 0 0 0 0 0 0 0 0 0 0 0 0    
0 0 0 0 0 0 0 0 0 0 0 0 0 0 0 0 0 0 0 0 0 0 0 0 0 0 0 0 0 0 0 0 0 0 0 0 0 0 0 0 0 0 0 0 0 0 0 0 0 0    
0 0 0 0 0 0 0 0 0 0 0 0 0 0 0 0 0 0 0 0 0 0 0 0 0 0 0 0 0 0 0 0 0 0 0 0 0 0 0 0 0 0 0 0 0 0 0 0 0 0    
0 0 0 0 0 0 0 0 0 0 0 0 0 0 0 0 0 0 0 0 0 0 0 0 0 0 0 0 0 0 0 0 0 0 0 0 0 0 0 0 0 0 0 0 0 0 0 0 0 0    
0 0 0 0 0 0 0 0 0 0 0 0 0 0 0 0 0 0 0 0 0 0 0 0 0 0 0 0 0 0 0 0 0 0 0 0 0 0 0 0 0 0 0 0 0 0 0 0 0 0 
0 0 0 0 0 0 0 0 0 0 0 0 0 0 0 0 0 0 0 0 0 0 0 0 0 0 0 0 0 0 0 0 0 0 0 0 0 0 0 0 0 0 0 0 0 0 0 0 0 0    
0 0 0 0 0 0 0 0 0 0 0 0 0 0 0 0 0 0 0 0 0 0 0 0 0 0 0 0 0 0 0 0 0 0 0 0 0 0 0 0 0 0 0 0 0 0 0 0 0 0    
0 0 0 0 0 0 0 0 0 0 0 0 0 0 0 0 0 0 0 0 0 0 0 0 0 0 0 0 0 0 0 0 0 0 0 0 0 0 0 0 0 0 0 0 0 0 0 0 0 0    
0 0 0 0 0 0 0 0 0 0 0 0 0 0 0 0 0 0 0 0 0 0 0 0 0 0 0 0 0 0 0 0 0 0 0 0 0 0 0 0 0 0 0 0 0 0 0 0 0 0    
0 0 0 0 0 0 0 0 0 0 0 0 0 0 0 0 0 0 0 0 0 0 0 0 0 0 0 0 0 0 0 0 0 0 0 0 0 0 0 0 0 0 0 0 0 0 0 0 0 0    
0 0 0 0 0 0 0 0 0 0 0 0 0 0 0 0 0 0 0 0 0 0 0 0 0 0 0 0 0 0 0 0 0 0 0 0 0 0 0 0 0 0 0 0 0 0 0 0 0 0    
0 0 0 0 0 0 0 0 0 0 0 0 0 0 0 0 0 0 0 0 0 0 0 0 0 0 0 0 0 0 0 0 0 0 0 0 0 0 0 0 0 0 0 0 0 0 0 0 0 0    
0 0 0 0 0 0 0 0 0 0 0 0 0 0 0 0 0 0 0 0 0 0 0 0 0 0 0 0 0 0 0 0 0 0 0 0 0 0 0 0 0 0 0 0 0 0 0 0 0 0 
0 0 0 0 0 0 0 0 0 0 0 0 0 0 0 0 0 0 0 0 0 0 0 0 0 0 0 0 0 0 0 0 0 0 0 0 0 0 0 0 0 0 0 0 0 0 0 0 0 0    
0 0 0 0 0 0 0 0 0 0 0 0 0 0 0 0 0 0 0 0 0 0 0 0 0 0 0 0 0 0 0 0 0 0 0 0 0 0 0 0 0 0 0 0 0 0 0 0 0 0    
0 0 0 0 0 0 0 0 0 0 0 0 0 0 0 0 0 0 0 0 0 0 0 0 0 0 0 0 0 0 0 0 0 0 0 0 0 0 0 0 0 0 0 0 0 0 0 0 0 0    
0 0 0 0 0 0 0 0 0 0 0 0 0 0 0 0 0 0 0 0 0 0 0 0 0 0 0 0 0 0 0 0 0 0 0 0 0 0 0 0 0 0 0 0 0 0 0 0 0 0