0 0 0 0 0 0 0 0 0 0 0 0 0 0 0 0 0 0 0 0 0 0 0 0 0 0 0 0 0 0 0 0 0 0 0 0 0 0 0 0 0 0 0 0 0 0 0 0 0 0 
0 0 0 0 0 0 0 0 0 0 0 0 0 0 0 0 0 0 0 0 0 0 0 0 0 0 0 0 0 0 0 0 0 0 0 0 0 0 0 0 0 0 0 0 0 0 0 0 0 0 
0 0 10 1 1 1 1 1 1 1 1 1 1 1 1 1 1 1 1 1 1 1 1 1 1 1 2 0 0 0 0 10 1 1 1 1 1 1 1 1 1 1 1 1 1 1 1 2 0 0 
0 0 5 7 9 7 9 7 9 7 9 7 9 7 9 7 9 7 9 7 9 7 9 7 9 7 3 0 0 0 0 5 9 7 9 7 9 7 9 7 9 7 9 7 9 7 9 3 0 0 
0 0 5 9 9 9 9 9 9 9 9 9 9 9 9 9 9 9 9 9 9 9 9 9 9 9 3 0 0 0 0 5 7 6 6 6 6 6 6 6 6 6 6 6 6 6 7 3 0 0 
0 0 5 7 9 9 9 9 9 9 9 9 9 9 9 9 9 9 9 9 9 9 9 9 9 7 3 0 0 0 0 5 9 6 6 6 6 6 6 6 6 6 6 6 6 6 9 3 0 0
0 0 5 9 9 9 9 9 9 9 9 9 9 9 9 9 9 9 9 9 9 9 9 9 9 9 3 0 0 0 0 5 7 6 6 6 6 6 6 6 6 6 6 6 6 6 7 3 0 0 
0 0 5 7 9 9 9 9 9 9 9 9 9 9 9 9 9 9 9 9 9 9 9 9 9 7 3 0 0 0 0 5 9 6 6 6 6 6 6 6 6 6 6 6 6 6 9 3 0 0 
0 0 5 9 9 9 9 9 9 9 9 9 9 9 9 9 9 9 9 9 9 9 9 9 9 9 3 0 0 0 0 5 7 6 6 6 6 6 6 6 6 6 6 6 6 6 7 3 0 0 
0 0 5 7 9 9 9 9 9 9 9 9 9 9 9 9 9 9 9 9 9 9 9 9 9 7 3 0 0 0 0 5 9 6 6 6 6 6 6 6 6 6 6 6 6 6 9 3 0 0 
0 0 5 9 9 9 9 9 9 9 9 9 9 9 9 9 9 9 9 9 9 9 9 9 9 9 3 0 0 0 0 5 7 6 6 6 6 6 6 6 6 6 6 6 6 6 7 3 0 0 
0 0 5 7 9 9 9 9 9 9 9 9 9 9 9 9 9 9 9 9 9 9 9 9 9 7 3 0 0 0 0 5 9 6 6 6 6 6 6 6 6 6 6 6 6 6 9 3 0 0 
0 0 5 9 9 9 9 9 9 9 9 9 9 9 9 9 9 9 9 9 9 9 9 9 9 9 3 0 0 0 0 5 7 6 6 6 6 6 6 6 6 6 6 6 6 6 7 3 0 0 
0 0 5 7 9 9 9 9 9 9 9 9 9 9 9 9 9 9 9 9 9 9 9 9 9 7 3 0 0 0 0 5 9 6 6 6 6 6 6 6 6 6 6 6 6 6 9 3 0 0 
0 0 5 9 9 9 9 9 9 9 9 9 9 9 9 9 9 9 9 9 9 9 9 9 9 9 3 0 0 0 0 5 7 6 6 6 6 6 6 6 6 6 6 6 6 6 7 3 0 0 
0 0 5 7 9 9 9 9 9 9 9 9 9 9 9 9 9 9 9 9 9 9 9 9 9 7 3 0 0 0 0 5 9 6 6 6 6 6 6 6 6 6 6 6 6 6 9 3 0 0 
0 0 5 9 9 9 9 9 9 9 9 9 9 9 9 9 9 9 9 9 9 9 9 9 9 9 3 0 0 0 0 5 7 6 6 6 6 6 6 6 6 6 6 6 6 6 7 3 0 0 
0 0 5 7 9 9 9 9 9 9 9 9 9 9 9 9 9 9 9 9 9 9 9 9 9 7 9 1 1 1 1 9 9 6 6 6 6 6 6 6 6 6 6 6 6 6 9 3 0 0
0 0 5 9 9 9 9 9 9 9 9 9 9 9 9 9 9 9 9 9 9 9 9 9 9 9 7 9 7 9 7 9 7 6 6 6 6 6 6 6 6 6 6 6 6 6 7 3 0 0 
0 0 5 7 9 8 8 6 6 8 8 8 8 8 8 8 8 8 8 8 8 8 8 8 8 8 8 8 8 8 8 8 8 6 6 6 6 6 6 6 6 6 6 6 6 6 9 3 0 0 
0 0 5 9 9 8 8 6 6 8 8 8 8 8 8 8 8 8 8 8 8 8 8 8 8 8 8 8 8 8 8 8 8 6 6 6 6 6 6 6 6 6 6 6 6 6 7 3 0 0 
0 0 5 7 9 8 8 6 6 8 8 8 8 8 8 8 8 8 8 8 8 8 8 8 8 8 8 8 8 8 8 8 8 6 6 6 6 6 6 6 6 6 6 6 6 6 9 3 0 0 
0 0 5 9 9 8 8 6 6 8 8 8 8 8 8 8 8 8 8 8 8 8 8 8 8 8 8 8 8 8 8 8 8 6 6 6 6 6 6 6 6 6 6 6 6 6 7 3 0 0 
0 0 5 7 9 8 8 6 6 8 8 8 8 8 8 8 8 8 8 8 8 8 8 8 8 8 8 8 8 8 8 8 8 6 6 6 6 6 6 6 6 6 6 6 6 6 9 3 0 0 
0 0 5 9 9 8 8 6 6 6 6 6 6 6 6 6 8 8 8 8 8 8 8 8 8 8 8 8 8 8 8 8 8 6 6 6 6 6 6 6 6 6 6 6 6 6 7 3 0 0 
0 0 5 7 9 8 8 6 6 6 6 6 6 6 6 6 8 8 8 8 8 8 6 6 6 6 6 6 6 6 6 6 6 6 6 6 6 6 6 6 6 6 6 6 6 6 9 3 0 0  
0 0 5 9 9 8 8 8 8 8 8 8 8 8 6 6 8 8 8 8 8 8 6 6 6 6 6 6 6 6 6 6 6 6 6 6 6 6 6 6 6 6 6 6 6 6 7 3 0 0   
0 0 5 7 9 8 8 8 8 8 8 8 8 8 6 6 8 8 8 8 8 8 6 6 8 8 8 8 8 8 8 6 6 6 6 6 6 6 6 6 6 6 6 6 6 6 9 3 0 0  
0 0 5 9 9 8 8 8 8 8 8 8 8 8 6 6 8 8 8 8 8 8 6 6 8 8 8 8 8 8 8 6 6 6 6 6 6 6 6 6 6 6 6 6 6 6 7 3 0 0  
0 0 5 7 9 8 8 8 8 8 8 8 8 8 6 6 6 6 6 6 6 6 6 6 8 8 8 8 8 8 8 6 6 6 6 6 6 6 6 6 6 6 6 6 6 6 9 3 0 0  
0 0 5 9 9 8 8 8 8 8 8 8 8 8 6 6 6 6 6 6 6 6 6 6 8 8 8 8 8 8 8 6 6 6 6 6 6 6 6 6 6 6 6 6 6 6 7 3 0 0 
0 0 5 7 9 8 8 8 8 8 8 8 8 8 8 8 8 8 8 8 8 8 6 6 8 8 8 8 8 8 8 6 6 6 6 6 6 6 6 6 6 6 6 6 6 6 9 3 0 0 
0 0 5 9 9 8 8 8 8 8 8 8 8 8 8 8 8 8 8 8 8 8 6 6 8 8 8 8 8 8 8 6 6 6 6 6 6 6 6 6 6 6 6 6 6 6 7 3 0 0 
0 0 5 7 9 8 8 8 8 8 8 8 8 8 8 8 8 8 8 8 8 8 6 6 8 8 8 8 8 8 8 6 6 6 6 6 6 6 6 6 6 6 6 6 6 6 9 3 0 0 
0 0 5 9 9 8 8 8 8 8 8 8 8 8 8 8 8 8 8 8 8 8 6 6 8 8 8 8 8 8 8 6 6 6 6 6 6 6 6 6 6 6 6 6 6 6 7 3 0 0 
0 0 5 7 9 8 8 8 8 8 8 8 8 8 8 8 8 8 8 8 8 8 6 6 8 8 8 8 8 8 8 6 6 6 6 6 6 6 6 6 6 6 6 6 6 6 9 3 0 0 
0 0 5 9 9 9 9 9 9 9 9 9 9 9 9 9 9 9 9 9 9 9 9 9 9 9 9 9 9 9 9 6 6 6 6 6 6 6 6 6 6 6 6 6 6 6 7 3 0 0  
0 0 5 7 9 7 9 7 9 7 9 7 9 7 9 7 9 7 9 7 9 7 9 7 9 7 9 7 9 7 9 6 12 12 12 12 12 12 12 12 12 12 12 12 12 6 9 3 0 0   
0 0 5 9 9 9 9 9 9 9 9 9 9 9 9 9 9 9 9 9 9 9 9 9 9 9 9 9 9 9 7 6 12 12 12 12 12 12 12 12 12 12 12 12 12 6 7 3 0 0  
0 0 5 9 9 9 9 9 9 9 9 9 9 9 9 9 9 9 9 9 9 9 9 9 9 9 9 9 9 9 9 6 12 12 12 12 12 12 12 12 12 12 12 12 12 6 9 3 0 0  
0 0 19 13 13 13 13 13 13 13 13 13 13 13 13 13 13 13 13 13 13 13 13 13 13 13 13 13 13 9 7 6 12 12 12 12 12 12 12 12 12 12 12 12 12 6 7 3 0 0  
0 0 0 0 0 0 0 0 0 0 0 0 0 0 0 0 0 0 0 0 0 0 0 0 0 0 0 0 0 5 9 6 12 12 12 12 12 12 12 12 12 12 12 12 12 6 9 3 0 0  
0 0 0 0 0 0 0 0 0 0 0 0 0 0 0 0 0 0 0 0 0 0 0 0 0 0 0 0 0 5 7 6 12 12 12 12 12 12 12 12 12 12 12 12 12 6 7 3 0 0  
0 0 0 0 0 0 0 0 0 0 0 0 0 0 0 0 0 0 0 0 0 0 0 0 0 0 0 0 0 5 9 6 12 12 12 12 12 12 12 12 12 12 12 12 12 6 9 3 0 0  
0 0 0 0 0 0 0 0 0 0 0 0 0 0 0 0 0 0 0 0 0 0 0 0 0 0 0 0 0 5 7 6 12 12 12 12 12 12 12 12 12 12 12 12 12 6 7 3 0 0  
0 0 0 0 0 0 0 0 0 0 0 0 0 0 0 0 0 0 0 0 0 0 0 0 0 0 0 0 0 5 9 6 6 6 6 6 6 6 6 6 6 6 6 6 6 6 9 3 0 0  
0 0 0 0 0 0 0 0 0 0 0 0 0 0 0 0 0 0 0 0 0 0 0 0 0 0 0 0 0 5 7 9 7 9 7 9 7 9 7 9 7 9 7 9 7 9 7 3 0 0  
0 0 0 0 0 0 0 0 0 0 0 0 0 0 0 0 0 0 0 0 0 0 0 0 0 0 0 0 0 19 13 13 13 13 13 13 13 13 13 13 13 13 13 13 13 13 13 18 0 0  
0 0 0 0 0 0 0 0 0 0 0 0 0 0 0 0 0 0 0 0 0 0 0 0 0 0 0 0 0 0 0 0 0 0 0 0 0 0 0 0 0 0 0 0 0 0 0 0 0 0  
0 0 0 0 0 0 0 0 0 0 0 0 0 0 0 0 0 0 0 0 0 0 0 0 0 0 0 0 0 0 0 0 0 0 0 0 0 0 0 0 0 0 0 0 0 0 0 0 0 0   