6 6 6 6 6 6 6 6 6 8 8 7 0 0 0 0 0 0 0 0 0 0 0 0 0 0 0 0 0 0 0 0 0 0 0 0 0 0 0 0 0 0 5 0 0 0 0 0 0 0 
6 6 6 6 6 6 7 0 0 0 0 0 0 0 0 0 38 37 37 37 37 37 37 37 37 37 37 37 37 37 37 37 37 41 0 0 0 0 0 0 0 0 0 0 0 4 0 0 0 0 
6 6 6 6 6 7 0 0 0 0 0 0 0 38 37 37 47 1 1 1 1 1 1 1 1 1 1 1 1 1 1 1 1 45 37 37 37 41 0 0 0 0 0 0 0 4 0 0 0 0
6 6 6 7 0 0 0 0 0 38 37 37 37 47 1 1 1 2 2 2 2 2 1 2 2 2 2 2 2 2 2 2 1 1 1 1 1 45 37 37 41 0 0 0 0 0 0 0 0 0    
6 6 7 0 0 0 0 38 37 47 1 1 1 1 2 2 2 2 2 2 2 2 1 1 2 2 2 2 2 2 2 2 2 2 2 2 2 2 1 1 45 37 41 0 0 0 0 0 0 0    
6 7 0 0 0 38 37 47 1 1 1 1 2 2 2 2 2 2 2 2 2 2 2 1 1 2 2 2 2 2 2 2 2 2 2 2 2 2 2 2 1 1 45 41 0 0 0 0 0 0   
7 0 0 0 38 47 54 54 54 1 1 1 2 2 2 2 2 2 2 2 2 2 2 2 1 1 1 1 2 2 2 2 2 1 1 1 1 1 1 2 2 1 1 45 37 41 0 0 0 0    
6 9 0 38 47 1 1 1 54 54 55 54 1 1 1 1 2 2 2 2 2 2 2 2 2 2 2 1 1 1 1 1 1 1 1 1 1 1 1 2 2 2 2 1 1 45 41 0 0 0    
9 0 38 47 46 44 44 44 44 44 44 44 44 48 1 1 1 1 1 1 2 2 2 2 2 2 2 2 1 2 2 2 2 1 1 1 1 1 1 2 2 2 2 2 1 1 45 41 0 0 
9 0 40 44 43 0 0 0 0 0 0 0 0 40 44 44 44 48 1 1 1 2 2 2 2 2 2 2 1 2 2 2 2 1 1 1 1 1 1 2 2 2 2 2 2 1 1 45 41 0   
6 6 6 0 0 0 0 0 0 0 0 0 0 0 0 0 0 40 48 1 1 1 2 2 2 2 2 1 1 2 2 2 2 1 1 1 1 1 1 52 51 2 2 2 2 2 1 1 42 0 0    
6 6 6 6 6 6 6 6 0 0 0 0 0 0 0 0 0 0 40 48 1 1 1 2 2 2 2 1 2 2 2 2 2 2 2 1 2 2 2 2 57 51 2 2 2 2 2 1 42 0    
6 6 6 6 6 6 6 6 6 0 0 0 0 0 0 0 0 0 0 40 48 1 1 1 2 2 2 1 2 2 2 2 2 2 2 1 2 2 2 2 2 2 2 2 2 2 2 2 42 0    
6 6 6 6 6 6 6 6 6 6 6 0 0 0 0 0 0 0 0 0 39 1 1 1 1 2 2 1 1 2 2 2 2 2 2 1 2 2 2 2 2 2 2 2 2 2 2 2 42 0    
6 6 6 6 6 6 6 6 6 6 6 0 0 0 0 5 0 0 0 0 39 1 1 1 1 2 2 2 1 2 2 2 2 2 2 1 2 2 2 2 2 2 2 2 2 2 2 2 42 0    
6 6 6 6 6 6 6 6 6 6 6 6 0 0 5 0 0 0 0 0 39 1 1 1 1 2 2 2 1 2 2 2 2 2 1 1 1 1 1 1 1 2 2 2 2 15 12 2 42 0    
6 6 6 6 6 6 6 6 6 6 6 6 0 0 0 0 0 0 0 0 39 1 1 1 1 2 2 2 1 2 2 2 2 1 1 15 11 11 11 14 14 11 12 2 2 16 13 2 42 0    
6 6 6 6 6 6 6 6 6 6 6 0 0 0 0 0 0 0 0 0 39 1 1 1 1 2 2 2 1 2 2 2 15 11 11 3 3 3 3 3 3 3 3 11 11 3 13 2 42 0    
6 6 6 6 6 6 6 6 6 6 0 0 0 0 0 0 0 0 5 0 39 1 1 1 1 2 2 2 1 2 2 2 16 3 3 3 3 3 3 15 11 11 11 11 12 3 13 2 42 0    
6 6 6 6 6 6 6 6 6 0 0 0 0 0 0 0 0 5 0 0 39 1 1 1 1 2 2 1 1 2 2 15 3 3 3 3 15 11 11 3 3 3 3 3 17 3 17 2 42 0    
6 6 6 6 6 6 6 6 6 6 0 0 0 0 0 0 0 0 0 38 47 1 1 1 2 2 2 1 2 15 11 3 3 3 3 3 16 3 3 3 3 3 3 17 3 17 2 46 43 0    
6 6 6 6 6 6 6 6 6 0 0 0 0 0 0 0 0 0 38 47 1 1 1 1 2 2 2 2 15 3 3 3 3 3 3 3 18 19 19 19 19 19 17 3 17 2 46 43 0 0    
6 6 6 0 0 0 0 0 0 0 0 0 0 0 0 0 0 38 47 1 1 1 1 2 2 2 2 15 3 3 3 3 3 3 3 3 3 3 3 3 3 3 3 13 2 46 43 0 0 0    
0 0 0 0 4 0 0 0 0 0 0 0 0 0 0 0 38 47 1 1 1 2 2 2 2 15 11 3 3 3 14 14 3 3 3 3 3 3 3 3 3 3 19 17 2 42 0 0 0 0     
0 0 0 38 37 37 41 0 0 0 0 0 0 0 0 38 47 1 1 1 2 2 2 2 15 3 3 3 3 13 1 1 18 3 3 19 19 19 19 19 19 17 2 2 46 43 0 0 0 0    
0 0 0 40 48 1 45 41 0 0 0 0 0 38 37 47 1 1 1 2 2 2 15 11 3 3 3 3 3 3 12 1 1 18 17 2 2 2 2 2 2 2 2 46 43 0 0 0 0 0    
0 0 0 0 40 44 48 45 37 37 37 37 37 47 1 1 2 2 2 2 2 15 3 3 3 3 3 3 3 19 17 2 1 1 2 2 2 2 2 2 2 1 46 43 0 0 0 0 0 0    
0 0 0 0 0 0 40 44 44 48 1 1 1 1 1 52 51 2 2 15 11 3 3 3 3 3 3 19 17 2 2 2 2 1 2 2 2 2 2 2 2 46 43 0 0 0 0 0 0 0     
0 0 0 0 0 0 0 0 0 40 44 48 1 1 1 55 2 2 2 18 19 19 19 19 19 19 17 2 2 2 2 2 1 2 2 2 2 2 2 2 46 43 0 0 0 0 0 0 0 0 0  
0 0 0 0 0 0 0 0 0 0 0 40 44 48 52 53 57 53 1 1 2 2 2 2 2 2 2 2 2 2 2 2 2 1 1 1 1 56 1 46 43 0 0 0 0 0 0 0 0 0    
0 0 0 0 0 0 0 0 0 0 0 0 0 40 44 44 44 44 44 48 1 1 2 2 2 2 2 2 1 1 1 1 1 1 1 46 44 44 44 43 0 0 0 0 0 0 0 0 0 0    
0 0 0 0 0 0 0 0 0 0 0 0 0 0 0 0 0 0 0 39 1 1 1 1 1 1 1 1 1 1 1 1 1 1 1 42 0 0 0 0 0 0 0 0 0 0 0 0 0 0    
0 0 0 0 0 0 0 0 0 0 0 0 0 0 0 0 0 0 0 40 44 44 44 44 44 48 1 1 1 1 1 1 1 1 1 45 41 0 0 0 0 0 0 0 0 0 0 0 0 0    
0 0 0 0 0 0 0 0 0 0 0 0 0 0 0 0 0 0 0 0 0 0 0 0 0 40 44 44 48 1 1 1 46 44 44 44 43 0 0 0 0 0 0 0 0 0 0 0 0 0    
0 0 0 0 0 0 0 0 0 0 0 0 0 0 0 0 0 0 0 0 0 0 0 0 0 0 0 0 40 44 48 46 43 0 0 0 0 0 0 0 0 0 0 0 0 0 0 0 0 0    
0 0 0 0 0 0 38 37 37 37 37 37 37 37 37 37 37 37 41 0 0 0 0 0 0 0 0 0 0 0 39 42 0 0 0 0 0 0 0 0 0 0 0 0 0 0 0 0 0 0    
0 0 0 0 38 37 47 1 1 1 1 1 1 1 1 1 1 1 45 41 0 0 38 37 41 0 0 0 0 0 39 42 0 38 37 37 37 37 37 37 37 37 37 37 37 37 37 41 0 0    
0 0 0 38 47 2 2 2 52 2 2 2 2 2 2 51 2 2 1 45 37 37 47 1 45 37 37 37 37 37 47 45 37 47 1 1 1 1 1 1 1 1 1 1 1 1 1 45 41 0    
0 0 38 47 1 1 1 1 1 1 1 1 1 1 2 2 2 2 2 2 2 1 1 1 2 1 1 1 1 1 1 1 1 1 1 1 1 1 1 1 1 1 1 1 1 1 1 1 42 0    
0 38 47 1 1 1 1 1 1 1 1 1 1 2 2 2 15 11 11 11 12 2 2 2 2 2 2 2 2 2 2 2 2 1 2 2 2 1 1 1 1 1 1 1 1 1 1 1 42 0    
0 39 1 1 1 1 1 1 1 1 1 1 2 2 2 15 15 11 11 11 12 11 12 2 2 2 2 2 2 2 2 2 2 1 2 2 2 1 1 10 1 1 1 1 1 1 1 1 42 0    
0 39 1 1 1 1 1 55 1 1 1 1 1 2 15 15 3 3 3 3 3 12 13 1 2 2 2 2 1 2 2 2 2 1 2 2 2 2 2 2 2 2 2 2 2 2 2 46 43 0 
0 40 48 1 1 1 1 1 1 1 1 1 1 1 18 19 16 3 3 3 3 17 17 1 1 2 2 2 1 1 1 1 2 1 1 1 1 1 1 1 1 1 1 1 1 1 1 42 0 0   
0 0 40 48 1 1 1 1 1 1 1 1 1 1 1 1 18 18 19 19 17 13 1 1 1 1 1 1 1 1 1 1 1 1 1 1 1 1 1 1 1 1 1 1 1 1 46 43 0 0    
0 0 0 40 48 1 1 1 1 1 1 1 1 1 1 1 1 18 19 19 19 17 2 2 2 2 2 2 1 1 1 1 1 1 1 1 1 1 1 1 1 1 1 1 1 46 43 0 0 0     
0 0 0 0 40 48 1 1 1 1 1 1 1 1 1 1 1 2 2 2 2 2 2 2 2 2 2 2 2 2 2 2 2 1 1 1 1 1 1 54 54 1 1 1 46 43 0 0 0 0      
0 0 0 0 0 40 48 1 1 56 1 1 1 1 1 1 1 1 1 1 1 1 1 1 1 1 1 1 1 1 1 1 1 1 1 1 1 1 1 1 1 1 1 46 43 0 0 0 0 0    
0 0 0 0 0 0 40 44 44 44 44 44 44 44 44 44 44 44 44 44 44 44 44 44 44 44 44 44 44 44 44 44 44 44 44 44 44 44 44 44 44 44 44 43 0 0 0 0 0 0    
0 0 0 0 0 0 0 0 0 0 0 0 0 0 0 0 0 0 0 0 0 0 0 0 0 0 0 0 0 0 0 0 0 0 0 0 0 0 0 0 0 0 0 0 0 0 0 0 0 0     
0 0 0 0 0 0 0 0 0 0 0 0 0 0 0 0 0 0 0 0 0 0 0 0 0 0 0 0 0 0 0 0 0 0 0 0 0 0 0 5 0 0 4 0 0 0 0 0 0 0        