0 0 0 0 0 0 0 0 0 0 0 0 0 0 0 0 0 0 0 0 0 0 0 0 0 0 0 0 0 0 0 0 0 0 0 0 0 0 0 0 0 0 0 0 0 0 0 0 0 0 
0 0 0 0 0 0 0 0 0 0 0 0 0 0 0 0 0 0 0 0 0 0 0 0 0 0 0 0 0 0 0 0 0 0 0 0 0 0 0 0 0 0 0 0 0 0 0 0 0 0 
0 0 0 0 0 0 0 0 0 0 0 0 0 0 0 0 0 0 0 0 0 0 0 0 0 0 0 0 0 0 0 0 0 0 0 0 0 0 0 0 0 0 0 0 0 0 0 0 0 0 
0 0 0 0 0 10 1 1 1 1 1 1 1 1 1 1 1 1 1 1 1 1 2 0 0 0 0 0 10 1 1 1 1 1 1 1 1 1 1 1 2 0 0 0 0 0 0 0 0 0 
0 0 0 0 0 5 7 9 9 7 9 7 9 7 9 7 9 9 7 9 9 7 3 0 0 0 0 0 5 8 8 8 8 8 8 8 8 8 8 8 3 0 0 0 0 0 0 0 0 0 
0 0 0 0 0 5 9 9 9 9 9 9 9 9 9 9 9 9 9 9 9 9 3 0 0 0 0 0 5 8 8 8 8 8 8 8 8 8 8 8 3 0 0 0 0 0 0 0 0 0
0 0 0 0 0 5 9 7 9 9 7 9 9 7 9 9 7 9 9 7 9 7 3 0 0 0 0 0 5 8 8 8 8 8 8 6 6 6 6 6 3 0 0 0 0 0 0 0 0 0 
0 0 0 0 0 5 9 9 9 9 9 9 9 9 9 9 9 9 9 9 9 9 3 0 0 0 0 0 5 8 8 8 8 8 8 6 6 8 8 8 3 0 0 0 0 0 0 0 0 0 
0 0 0 0 0 5 8 8 6 6 8 8 8 8 8 8 8 8 8 8 8 8 3 0 0 0 0 0 5 8 6 6 6 6 6 6 6 8 8 8 3 0 0 0 0 0 0 0 0 0 
0 0 0 0 0 5 8 8 6 6 8 8 8 8 8 8 8 8 8 8 8 8 3 0 0 0 0 0 5 8 6 6 6 6 6 6 6 8 8 8 3 0 0 0 0 0 0 0 0 0 
0 0 0 0 0 5 8 8 6 6 8 8 8 6 8 8 8 8 8 8 8 8 3 0 0 0 0 0 5 8 6 6 6 6 6 6 6 8 8 8 3 0 0 0 0 0 0 0 0 0 
0 0 0 0 0 5 8 8 6 6 8 8 8 6 8 8 8 8 8 8 8 8 3 0 0 0 0 0 5 8 6 8 8 8 8 8 6 8 8 8 3 0 0 0 0 0 0 0 0 0 
0 0 0 0 0 5 8 8 6 6 8 8 8 6 8 8 8 8 8 8 8 8 3 0 0 0 0 0 5 8 6 8 8 8 8 8 6 8 8 8 3 0 0 0 0 0 0 0 0 0 
0 0 0 0 0 5 8 8 6 6 8 8 8 6 8 8 8 8 8 6 8 8 3 0 0 0 0 0 5 8 6 8 8 8 8 8 6 8 8 8 3 0 0 0 0 0 0 0 0 0 
0 0 0 0 0 5 8 8 6 6 6 6 6 6 6 8 8 8 8 6 8 8 3 0 0 0 0 0 5 8 6 8 8 8 8 8 6 8 8 8 3 0 0 0 0 0 0 0 0 0 
0 0 0 0 0 5 8 8 6 6 6 6 6 8 6 8 8 8 8 6 8 8 3 0 0 0 0 0 5 8 6 8 8 8 8 8 6 8 8 8 3 0 0 0 0 0 0 0 0 0 
0 0 0 0 0 5 8 8 6 6 8 8 8 8 6 8 8 8 8 6 8 8 3 0 0 0 0 0 5 8 6 8 8 8 8 8 6 8 8 8 3 0 0 0 0 0 0 0 0 0 
0 0 0 0 0 5 8 8 6 6 8 8 8 8 6 8 8 8 8 6 8 8 3 0 0 0 0 0 5 8 6 8 8 8 8 8 6 8 8 8 3 0 0 0 0 0 0 0 0 0 
0 0 0 0 0 5 8 8 6 6 8 8 8 8 6 8 8 8 8 6 8 8 3 0 0 0 0 0 5 8 6 8 8 8 8 8 6 8 6 8 3 0 0 0 0 0 0 0 0 0 
0 0 0 0 0 5 8 8 6 6 8 8 8 8 6 8 8 8 8 6 8 8 3 0 0 0 0 0 5 8 6 8 8 8 8 8 6 8 6 8 3 0 0 0 0 0 0 0 0 0 
0 0 0 0 0 5 8 8 6 6 8 8 8 8 6 8 8 8 8 6 8 8 3 0 0 0 0 0 5 8 6 8 8 8 8 8 6 8 6 8 3 0 0 0 0 0 0 0 0 0 
0 0 0 0 0 5 8 8 6 6 8 8 8 8 6 8 8 8 8 6 8 8 3 0 0 0 0 0 5 8 6 8 8 8 8 8 6 8 6 8 3 0 0 0 0 0 0 0 0 0 
0 0 0 0 0 5 6 6 6 6 8 8 8 8 6 6 6 6 8 6 6 6 3 0 0 0 0 0 5 8 6 8 8 8 8 8 6 8 6 8 3 0 0 0 0 0 0 0 0 0
0 0 0 0 0 5 8 8 6 6 8 8 8 8 6 8 8 8 8 6 8 8 3 0 0 0 0 0 5 8 6 8 8 8 8 8 6 8 6 6 3 0 0 0 0 0 0 0 0 0 
0 0 0 0 0 5 8 8 8 6 8 8 8 8 6 8 8 8 8 6 8 8 3 0 0 0 0 0 5 8 6 8 8 8 8 8 6 8 8 6 3 0 0 0 0 0 0 0 0 0 
0 0 0 0 0 5 8 8 8 6 8 8 8 8 6 8 8 8 8 6 8 8 3 0 0 0 0 0 5 8 6 8 8 8 8 8 6 8 8 6 3 0 0 0 0 0 0 0 0 0 
0 0 0 0 0 5 8 8 8 6 8 8 8 8 8 8 8 8 8 6 8 8 3 0 0 0 0 0 5 8 6 8 8 8 8 8 6 6 6 6 3 0 0 0 0 0 0 0 0 0 
0 0 0 0 0 5 8 8 8 6 8 8 8 8 8 8 8 8 8 6 8 8 3 0 0 0 0 0 5 8 6 8 8 8 8 8 6 8 8 8 3 0 0 0 0 0 0 0 0 0 
0 0 0 0 0 5 8 8 8 6 8 8 8 8 8 8 8 8 8 6 8 8 9 1 1 1 1 1 9 8 6 8 8 8 8 8 6 8 8 8 3 0 0 0 0 0 0 0 0 0  
0 0 0 0 0 5 8 8 8 6 8 8 8 8 8 8 8 8 8 6 8 8 8 8 8 8 8 8 8 8 6 8 8 8 8 8 6 8 8 8 3 0 0 0 0 0 0 0 0 0 
0 0 0 0 0 5 8 8 8 6 8 8 8 8 8 8 8 8 8 6 8 8 8 8 8 8 8 8 8 8 6 8 8 8 8 8 6 8 8 8 3 0 0 0 0 0 0 0 0 0 
0 0 0 0 0 5 8 8 8 6 8 8 8 8 8 8 8 8 8 6 8 8 8 8 8 8 8 8 8 8 6 8 8 8 8 8 6 8 8 8 3 0 0 0 0 0 0 0 0 0 
0 0 0 0 0 5 8 8 8 6 6 6 6 6 6 6 6 6 6 6 8 12 12 12 12 12 12 12 12 12 12 12 8 8 8 8 6 6 8 8 3 0 0 0 0 0 0 0 0 0  
0 0 0 0 0 5 8 8 8 6 8 8 8 8 6 6 6 6 6 6 8 12 12 12 12 12 12 12 12 12 12 12 8 8 8 8 8 6 8 8 3 0 0 0 0 0 0 0 0 0 
0 0 0 0 0 5 8 8 8 6 8 8 8 8 6 6 6 6 6 6 8 12 12 12 12 12 12 12 12 12 12 12 8 8 8 8 8 6 8 8 3 0 0 0 0 0 0 0 0 0 
0 0 0 0 0 5 8 8 8 6 8 8 8 8 6 6 6 6 6 6 8 12 12 12 12 12 12 12 12 12 12 12 8 8 8 8 8 6 8 8 3 0 0 0 0 0 0 0 0 0 
0 0 0 0 0 5 8 8 8 6 8 8 8 8 6 6 6 6 6 6 6 12 12 12 12 12 12 12 12 12 12 12 8 8 8 8 8 6 8 8 3 0 0 0 0 0 0 0 0 0
0 0 0 0 0 5 8 8 8 6 6 6 6 6 6 6 6 6 6 6 6 12 12 12 12 12 12 12 12 12 12 12 8 8 8 8 8 6 8 8 3 0 0 0 0 0 0 0 0 0 
0 0 0 0 0 5 8 8 8 6 8 8 8 8 8 8 8 8 8 8 8 12 12 12 12 12 12 12 12 12 12 12 8 8 8 8 8 6 8 8 3 0 0 0 0 0 0 0 0 0  
0 0 0 0 0 19 13 13 13 13 13 13 13 13 13 13 13 13 13 9 8 12 12 12 12 12 12 12 12 12 12 12 8 7 13 13 13 13 13 13 18 0 0 0 0 0 0 0 0 0 
0 0 0 0 0 0 0 0 0 0 0 0 0 0 0 0 0 0 5 7 8 12 12 12 12 12 12 12 12 12 12 12 8 7 3 0 0 0 0 0 0 0 0 0 0 0 0 0 0 0  
0 0 0 0 0 0 0 0 0 0 0 0 0 0 0 0 0 0 5 7 8 12 12 12 12 12 12 12 12 12 12 12 8 7 3 0 0 0 0 0 0 0 0 0 0 0 0 0 0 0 
0 0 0 0 0 0 0 0 0 0 0 0 0 0 0 0 0 0 5 7 8 12 12 12 12 12 12 12 12 12 12 12 8 7 3 0 0 0 0 0 0 0 0 0 0 0 0 0 0 0 
0 0 0 0 0 0 0 0 0 0 0 0 0 0 0 0 0 0 5 7 7 7 7 7 7 7 7 7 9 9 7 7 7 7 3 0 0 0 0 0 0 0 0 0 0 0 0 0 0 0  
0 0 0 0 0 0 0 0 0 0 0 0 0 0 0 0 0 0 19 13 13 13 13 13 13 13 13 13 13 13 13 13 13 13 18 0 0 0 0 0 0 0 0 0 0 0 0 0 0 0  
0 0 0 0 0 0 0 0 0 0 0 0 0 0 0 0 0 0 0 0 0 0 0 0 0 0 0 0 0 0 0 0 0 0 0 0 0 0 0 0 0 0 0 0 0 0 0 0 0 0  
0 0 0 0 0 0 0 0 0 0 0 0 0 0 0 0 0 0 0 0 0 0 0 0 0 0 0 0 0 0 0 0 0 0 0 0 0 0 0 0 0 0 0 0 0 0 0 0 0 0  
0 0 0 0 0 0 0 0 0 0 0 0 0 0 0 0 0 0 0 0 0 0 0 0 0 0 0 0 0 0 0 0 0 0 0 0 0 0 0 0 0 0 0 0 0 0 0 0 0 0  
0 0 0 0 0 0 0 0 0 0 0 0 0 0 0 0 0 0 0 0 0 0 0 0 0 0 0 0 0 0 0 0 0 0 0 0 0 0 0 0 0 0 0 0 0 0 0 0 0 0  
0 0 0 0 0 0 0 0 0 0 0 0 0 0 0 0 0 0 0 0 0 0 0 0 0 0 0 0 0 0 0 0 0 0 0 0 0 0 0 0 0 0 0 0 0 0 0 0 0 0   